GREEDY Visualization (Scale: 1 char = 20mm)
Grid Size: 600x600
--------------------------------
|CCCCCTTTTTSSSSS..........CCCCC|
|CCCCCTTTTTSSSSS..........CCCCC|
|CCCCC....................CCCCC|
|CCCCC....................CCCCC|
|CCCCC....................CCCCC|
|..............................|
|..............................|
|..............................|
|..............................|
|..............................|
|..............................|
|..............................|
|..............................|
|..............................|
|..............................|
|..............................|
|..............................|
|..............................|
|..............................|
|..............................|
|..............................|
|..............................|
|..............................|
|..............................|
|..............................|
|CCCCC....................CCCCC|
|CCCCC....................CCCCC|
|CCCCC....................CCCCC|
|CCCCC....................CCCCC|
|CCCCC....................CCCCC|
--------------------------------
