BACKTRACKING Visualization (Scale: 1 char = 20mm)
Grid Size: 400x400
----------------------
|CCCCCRRRRRRRRRRCCCCC|
|CCCCCRRRRRRRRRRCCCCC|
|CCCCCRRRRRRRRRRCCCCC|
|CCCCCRRRRRRRRRRCCCCC|
|CCCCCRRRRRRRRRRCCCCC|
|RRRRRRRRRRRRRRRRRRRR|
|RRRRRRRRRRRRRRRRRRRR|
|RRRRRRRRRRRRRRRRRRRR|
|RRRRRRRRRRRRRRRRRRRR|
|RRRRRRRRRRRRRRRRRRRR|
|RRRRRRRRRRRRRRRRRRRR|
|RRRRRRRRRRRRRRRRRRRR|
|RRRRRRRRRRRRRRRRRRRR|
|RRRRRRRRRRRRRRRRRRRR|
|RRRRRRRRRRRRRRRRRRRR|
|CCCCCRRRRRRRRRRCCCCC|
|CCCCCRRRRRRRRRRCCCCC|
|CCCCCRRRRRRRRRRCCCCC|
|CCCCCRRRRRRRRRRCCCCC|
|CCCCCRRRRRRRRRRCCCCC|
----------------------
